NO ./img/no.xpm
SO ./img/so.xpm
WE ./img/we.xpm
EA ./img/ea.xpm
F 220,100,0
C 225,30,0

11111111111111111111111111111111111111111111111111
10000000000000000000000011000000000000000000000001
11000000000000000000000011100000000000000000000001
10000000000000000000000011000000000000000000000001
11111111100000000000000001111111110000000000000001
10000000000000000000000001000000000000000000000001
10000000000000N10000000000000000000000001000000001
10000000000000000000000001000000000000000000000001
10000000000000000000000001000000000000000000000001
10000000000000000000000001000000000000000000000001
10000000000000000001010001000000000000000000101001
11000001110101011111011111100000111010101111101111
11110111 1110111 1011110111110111 1110101 10111101
11110111 1111111 1111111111111111 1111101 11111111
11110111111111111111111111111111111111101111111111
10000000000000000000000011000000000000000000000001
11000000000000000000000011100000000000000000000001
10000000000000000000000011000000000000000000000001
11111111100000000000000001111111110000000000000001
10000000000000000000000001000000000000000000000001
10000000000000010000000000000000000000001000000001
10000000000000000000000001000000000000000000000001
10000000000000000000000001000000000000000000000001
10000000000000000000000001000000000000000000000001
10000000000000000001010001000000000000000000101001
11000001110101011111011111100000111010101111101111
11110111 1110111 1011110111110111 1110111 10111101
11111111 1111111 1111111111111111 1111111 11111111
