NO ./img/so.xpm
SO ./img/so.xpm
WE ./img/bluestone.xpm
EA ./img/bluestone.xpm
F 220,100,0
C 225,30,0

111111111111111
110000000000001
100000000000001
10N000000000001
100000000000001
100000000000001
100000000000001
100000000000001
100000000000001
110000000000001
111111111111111
