NO ./img/no.xpm
SO ./img/so.xpm
WE ./img/we.xpm
EA ./img/ea.xpm
F 220,100,0
C 225,30,0

        111111111111111111111111
        1000000S0000000000000001
        100000000000000000000001
        100000000000000000000001
        100000000000000000000001
        100000000000000000000001
        100000000000000000000001
        100000000000000000000001
11111111100000000000000000000001
10000000000000000000000000000001
10000000000000000000000000000001
10000000000000000000000000000001
10000000000000000000000000000001
10000000000000000000000000000001
10000000000000000000000000000001
10000000000000000000000000000001
10000000000000000000000000000001
10000000000000000000000000000001
10000000000000000000000000000001
10000000000000000000000000000001
10000000000000000000000000000001
10000000000000000000000000000001
10000000000000000000000000000001
10000000000000000000000111111111
100000000000000000000001
100000000000000000000001
100000000000000000000001
100000000000000000000001
100000000000000000000001
100000000000000000000001
100000000000000000000001
111111111111111111111111
