NO ./img/so.xpm
SO ./img/so.xpm
WE ./img/bluestone.xpm
EA ./img/bluestone.xpm
F 220,100,0
C 225,30,0

  11111 111111111
  10001 100000001
1110001 100000111
100S001 1000001
1000001 100000111
1000001 100000001
1000001 100000001
1000001 100000001
10000011100000001
10000000000000111
111111111111111
