NO ./img/so.xpm
SO ./img/so.xpm
EA ./img/bluestone.xpm
WE ./img/bluestone.xpm
F 220,100,0
C 225,30,0

 11111111111111
111000100010001
101010101010101
1N1010101010101
101010101010101
101010101010101
101010101010101
101010101010101
101010101000101
100010001111111
111111111
