NO ./img/no.xpm
SO ./img/so.xpm
WE ./img/we.xpm
EA ./img/ea.xpm
S ./img/item.xpm
F ./img/no.xpm
C ./img/ea.xpm

        1111111111111111111111111
		1000000000000000000000001
        1100000000000000000000001
        1000000000000000000000001
111111111000000000000000000000001
10000000000000N000000000000001111
10000000000000000000000000001
10000000000000000000000000001
10000000000000000000000000001
10000000000000000000000000001
10000000000000000001010000001
11000001110101011111011110101
11110111 1110111 101111010001
11111111 1111111 111111111111
