NO ./img/no.xpm
SO ./img/so.xpm
WE ./img/we.xpm
EA ./img/ea.xpm
F 220,100,0
C 225,30,0

111111111
100010001
110000001
110000011
1100E0011
110000011
100000001
100011001
111111111
